R 1920 1080
NO /Users/btammara/Desktop/w_xpm/WALL32.xpm
SO /Users/btammara/Desktop/w_xpm/WALL101.xpm
WE /Users/btammara/Desktop/w_xpm/WALL102.xpm
EA /Users/btammara/Desktop/w_xpm/WALL104.xpm

S /Users/btammara/Desktop/w_xpm/WALL105.xpm
F 220,100,0
C 225,30,0

1111111111111111111111111
1000000000000000000000001
1000000002002002002000001
1000000000200200200200001
10000000000200200200200N1
1000000000200000200200001
1000000002000002002000001
1111111111111111111111111