R 1920 1080
NO /Users/btammara/Desktop/north_1.xpm
SO /Users/btammara/Desktop/south_1.xpm
WE /Users/btammara/Desktop/west_1.xpm
EA /Users/btammara/Desktop/east_1.xpm

S /Users/btammara/Desktop/officer_pr.xpm
F 220,100,0
C 225,30,0


1111111111111111111111111
1000000000000000000000001
1000000000002000000000001
1000000000000000000000001
1000000000002000000000001
1000000000000000000000001
100000000000N000000000001
1111111111111111111111111