R 1920 1080
NO ./path_to_the_north_texture
SO ./path_to_the_south_texture
WE ./path_to_the_west_texture
EA ./path_to_the_east_texture

S ./path_to_the_sprite_texture
F 220,100,0
C 225,30,0

   11        1      1111111    1111
  1001111111101111111000001    1001
  1000000000110000000000001    1001
  1011000001110000002000001    1111
  1001000000000000000000001
  111111111011000001110000011111111
  111111111011000001110000000000001
  100000000011000001110111100111111
11110111111111011100000010001
11110111111111011101010010001
11000000110101011100000010001
10002000000000001100000010001
10000000000000001101010N10001
1100000111010101111101101000111
11110111111101011100011010001
11111111111111111111111111111