R 1920 1080
NO /Users/btammara/Desktop/north_1.xpm
SO /Users/btammara/Desktop/south_1.xpm
WE /Users/btammara/Desktop/west_1.xpm
EA /Users/btammara/Desktop/east_1.xpm

S /Users/btammara/Desktop/officer_pr.xpm
F 220,100,0
C 225,30,0

1111111111111111
1111000000001111
1110000000000111
1100000000000011
1100000000000011
1100000000000011
1110000000000111
1111000000001111
11100000000000111
1111111001111111111111111111111111111111111111111111111111111111
1000000000000000000000000000000000000000000000000000000000000001
10000000000000000000000000000000000000000000000000000000000000011
11111111111001111111111111111110011111111111111111001111111111111
1000000000000000000000000000000000000000000000000000000000000001
1100111111100000000000000000000000000000000000000000000000000001
1100111111100000000000000000000001111111100000111100000000000001
11000001111000000000000000000000011111111000001111000000000000011
11000001111000000000000000000000011111111001111111000000000000011
11111111111000000000000000000000011111111001111111000000000000011
111111111110011111111111111111100111111110011111110000000000000111
1000000000000000000000000000000000000000000000000000000000000001
10000000000000000000000000000000000000000000000000000000000000011
11111111111001111111111111111110011111111111111111001111111111111
11111111111001111111111111111110011111111111111111001111111111111
11111111111001111111111111111110011111111111111111001111111111111
11111111111001111111111111111100111111111111111111001111111111111
1000000000000000000000000000000000000000000000000000000000000001
1000000000000000000000000000000000000000000000000000000000000001
1000000000000000000000000000000000000000000000000000000000000001
1000000000000000000000000000000000000000000000000000000000000001
1000000000000000000000000000000000000000000000000000000000000001
1111111111100111111111111111111111111111111111111001111111111111
1111111111100111111111111111111111111111111111111001111111111111
1111111111100111111111111111111111111111111111111001111111111111
1111111111100111111111111111111111111111111111111001111111111111
1000000000000000000000000000000000000000000000000000000000000001
1000000000000000000000000000000000000000000000000000000000000001
1000000000000000000000000000000000000000000000000000000000000001
1000000000000000000000000000000000000000000000000000000000000001
10000000000000000000000000000000000N0000000000000000000000000001
1111111111111111111111111111111111111111111111111111111111111111