R 1920 1080
NO ./path_to_the_north_texture
SO ./path_to_the_south_texture
WE ./path_to_the_west_texture
EA ./path_to_the_east_texture

S ./path_to_the_sprite_texture
F 220,100,0
C 225,30,0
                               
  11        1      1111111
 111111111111111111111111111
10000000000000000000000000001  
10000000000000000000000000001  
10000000000000000000000000001  
 1111011111111111111111111111
100001000000100100100000000001  
10000010000100100100000000001  
100000010010010010000000000001  
 1111110101101101111111111111
10000000000000000000000000001  
1000000000N000000000000000001  
 111111111111111111111111111
                                  