R 1920 1080
NO ./path_to_the_north_texture
SO ./path_to_the_south_texture
WE ./path_to_the_west_texture
EA ./path_to_the_east_texture

S ./path_to_the_sprite_texture
F 220,100,0
C 225,30,0

1111111111111111111111
1010000000000000111111
1101000000000000000011
1010100000111111000001
1101010111111111111111
1010101000000101000111
1101010100000000000111
1010101010N01111010101
1101010101011010101011
1111111111111111111111