R 1920 1080
NO /Users/btammara/Desktop/north_1.xpm
SO /Users/btammara/Desktop/south_1.xpm
WE /Users/btammara/Desktop/west_1.xpm
EA /Users/btammara/Desktop/east_1.xpm

S /Users/btammara/Desktop/wifi.xpm
F 220,100,0
C 225,30,0

11111111111111111111111111111111111
10000000000000200000000000000000001
10000000000002000000000121000000001
10000000000020000000000000000000001
10000000000000000000000000000000001
10000000000000000001000000001000001
12000000000000000002000N00002000001
10200000000200000001000000001000001
10020000000000000000000000000000001
10000020000000000000000121000000001
10000200000000000000000000000000001
10002000000000000000000000000000001
11111111111111111111111111111111111