R 1920 1080
NO /Users/btammara/Desktop/north_1.xpm
SO /Users/btammara/Desktop/south_1.xpm
WE /Users/btammara/Desktop/west_1.xpm
EA /Users/btammara/Desktop/east_1.xpm

S /Users/btammara/Desktop/wifi.xpm
F 142, 218, 232
C 142, 218, 54
   
111111111111111111111111111111111111
100010001000000200000000000000000001
100100000100002000000000121000000001
101000N00010020000000000000000000001
100100000100000000000000000000000001
100010001000000000001000000001000001
120001010000000000002000000002000001
102000000002000000001000000001000001
100200000000000000000000000000000001
100000200000000000000000121000000001
100002000000000000000000000000000001
100020000000000000000000000000000001
11111111111111111111111111111111111